11111111111111111111111111111111
1P000000000000000000000000000001
10000000X00000000000000000000001
10000000000000C00000000000000001
10000000000000000000000000000001
10000000000000000000000000000001
1000000000000C000000000000000001
10000000000000000000000000000001
10000000000000000000000000000001
10000000CE0000000000010000000001
10000000000000000000010000000001
10000000000000000000000000000001
10000000000000C00000010000000001
10000000000000000000010000000001
10000000000000000000010000000001
10000000000000000000010000000001
11111111111111111111111111111111
