11111111111111111111111111
10000000000000000000000001
1C0P000C000000000000000001
110E0000000000000000000001
11111111111111111111111111
